Position,Team,GP,W,D,L,GS,GC,GD,Pts
1,Algeti,18,12,2,4,60,45,15,38
2,Blancos United,18,11,2,5,48,39,9,35
3,Melomania,18,9,3,6,47,45,2,30
4,Dinamo Tbilisi,18,9,2,7,48,44,4,29
5,Zugdidi,18,8,3,7,50,40,10,27
6,Amkal,18,8,2,8,59,48,11,26
7,Rioni,18,8,2,8,59,51,8,26
8,Zenit,18,7,4,7,52,53,-1,25
9,Rubin,18,7,3,8,43,43,0,24
10,Saburtalo,18,5,3,10,43,57,-14,18
11,Shark Team,18,5,2,11,40,60,-20,17
12,Gardabani,18,4,2,12,30,45,-15,14
